3 2 3 4 3 
2 1 4 2 1 
3 4 5 1 2 
5 3 1 1 5 
5 1 2 3 5 
