4 5 1 1 1 
2 3 5 2 4 
3 2 4 1 2 
2 1 3 5 4 
1 2 4 3 1 
